########  
#P    ## 
# O   ##
# #   O#
#a# aa #
#O#    #
########