######
##    ## 
# OOa    #
# a    a #
#        #
#  #P O###
#########3