##############
#            #
#   P  a  O  #
#            #
##############