#######  
#P    ## 
# Oa@  #
# # O  #
#   a  #
#      #
########