######
##    #### 
# OOa    #
# a    a #
#        #
#  #P O###
##########