######
##    ## 
#      #
# OO   #
# # aaa#
#   #PO#
########